1111111111111111111111111
1010000000000000000000001
1110000000000000000000001
1000000000000000000000001
1000000000000000000000001
1000000000000000000E00001
1000000000000000000000001
1000000000000C00000000001
1000000000000000000000001
1000000000000000000000001
1000000000000000000000001
1000000000000000000000001
100000000000P000000000001
1000000000000000000000001
1000000000000000000000001
1000000000000000000000001
1000000000000000000000001
1000000000000000000000001
1000000000000000000000001
1000000000000000000000001
1000000000000000000000001
1000000000000000000000001
1000000000000000000000001
1000000000000000000000001
1111111111111111111111111
