11111111111111111
10C000010000P0001
10C00001000000001
10C00001000000001
10C00001000000001
10C0000E000000001
10C00000000000001
10C00000000000001
10C00000000000001
11111111111111111
