1111111111111
10011C0000001
1000001111001
1P00100000001
1111111111111
