111111
1C01P1
1E0100
101101
10C001
111111
