111111111111111
10C0E0010000001
10C000010000001
10C0000100P0001
10C000010000001
10C000010000001
10C000000000001
111111111111111
